############
S          #
#  #   ##  #
#  #   ##  #
#  # ### ###
#  #       #
#  ### #####
#  #   #   #
#  #       E
############
