############
#  ##      #
#  #   ##  #
#  #   ##  #
#  # ### # #
#          #
#  #########
#  #   #   #
#          #
############
