############
S  $    2  #
#  #   ##  #
#  #   ##  #
#  # ### ###
#  #       #
#1 ###%#####
#  #   #   #
#  #       E
############

1$
2%