############
S       %  #
#  #   ##  #
#  #   ##  #
#  #2### ###
#  #       #
#$ ###1#####
#  #   #   #
#  #       E
############

1$
23
8*
9(