#########
#       # 
#   #  E#
S   #   #
#  2$   #
#   #   #
#########

2$
