#################
#   #           #
#   #        %  E
##v######       #
#       #       #
#       #   #   #
#           #####
#  #######  #   #
#  #     #  #   #
#  #  ##$####   #
#  #  #     #   #
#  #  # 123 #   #
#  O  #  S  #   #
#################

2$
1%
3O
