############
#   #   #  #
#   $   v  E
#   #   ####
S  2#      #
#   ####   #
#   #  #   #
#   % 1#   #
#   #  #  3#
############

1v
2$
3%
