#############
#    %  #   #
# 3  #  v   #
#    #  #   #
##$###  #####
#    #  #   #
# 12 #  #   #
#    #  #   #
#  S #     E#
#############

1$
2%
3v
