############
#    S     #
#  1 2 3   #
#          #
##$##%###v##
#   #  #   #
#   #  #####
#   #  #   #
#      #   #
#   #      #
#   #  #  E#
############

1%
2v
3$
