########################
#              f    Q  E
################    #  #
#              #    P  #
#          #####    ####
#          #   O    #  #
#     ######   #    #  #
#     #    z  6#789 #  #
#     # ####x########  #
#     # #  # #         #
#     # #  # #         #
#     # #### ####   ####
#     #         #   #  #
#     ########  #####  #
#            #      y 3#
#######      #  ##### 4#
#     #      #  #   #  #
#####v#      #  #   ####
#   # #      #  #      #
##### ########  #      #
#S1 $ %        5#      #
##### ###########      #
#   #2#                #
########################

1$
2%
5y
3z
4x
6O
7f
9Q
8P
